##################
#                #
                 # 
                 # 
#        #########
#                #
######           #
#                #
#                #
######   #########
